#####################
#   #   # # #       #
# ##### # # ### ### #
#     #       #   # #
# # ### ### ### ### #
# #       #   #   # #
### # # ### ### ### #
# # # # #     #   # #
# ####### # ### ### #
#   #     # #     # #
# ##### # ##### ### #
#   #   # #     # # #
# ##### ### ### # ###
#   #     # #       #
# ##### ##### ### ###
#   #     # # # #   #
# ##### ### ### # ###
# # #         #     #
# # ### # # ### ### #
#       # #       # #
#####################
