#####################
#     #             #
# # ### ########### #
# #   # # # # # #   #
### ##### # # # ### #
#     # #         # #
# # ### # ### # ### #
# # # #     # #   # #
# ### # ####### ### #
#         # #       #
# # # # ### ### # ###
# # # # #     # #   #
######### ### ### ###
#           # #     #
# ####### # ##### ###
# # # # # # #       #
# # # # ####### # ###
#       # #     # # #
# # ### # ### # ### #
# # #         #     #
#####################
