#####################
#   #       #       #
### ####### # # ### #
# #       #   #   # #
# ####### # ##### # #
#       # # #   # # #
# ##### # # # # # ###
#     #   #   # #   #
##### ############# #
#   # #       #     #
# # # # # ### # ### #
# # # # #   #   #   #
# # # ### # ##### ###
# # #   # #   # # # #
# ##### # ### # # # #
#     # # # # # # # #
# # # # # # # # # # #
# # # # #   # #   # #
# # ### ##### # ### #
# #           #     #
#####################
