#####################################################################################################
#   #           #             #         #   # #               #   #       #         #             # #
# ##### ### ####### ### ### ### ### # ##### # # ########### ### ##### ### ### # ### # ### # # # ### #
#     # #     #     # #   #       # #     #     # # # # # #     #     #       # #     # # # # #   # #
# # ####### ##### ### # ### # # ##### # ### ### # # # # # ######### # ### # # ####### # ####### ### #
# #     #   #     # #     # # # #   # #   # #             # # #     # # # # # # # #     # #         #
### # ##### ### ### # ########### ##### ### ### # # # ### # # ### # ### ####### # ##### # ##### # # #
# # #   # #     # #     #         #       #   # # # # #       #   # # # # #       # #     # #   # # #
# ### ### ####### # ##### ### ####### # ### ############# ### ### ### # # ####### # ##### # ####### #
# #         # # #     # #   #   #     # #     #       # # # # #             # # #     #       #     #
# ### # # ### # # ##### # ######### # ### # ### ### ### ### # ### # # # # ### # ##### ##### ### # # #
#   # # #           # #   # # # #   # # # #       #     #       # # # # #         #     # #   # # # #
# ####### # # # # ### # ### # # ### ### ### # # ### # # ### ### ######### # # # ##### ### # ### #####
#     # # # # # # #     #       #         # # # # # # # # #   #   #     # # # #     # #       #     #
# ##### ############### ### ### ### # # ######### ### ### # ### ####### ####### # ### ### ##### # ###
# # #       # # # # #       #     # # #   #       #   #       #   # #         # #     #     #   #   #
# # ### ### # # # # ############# ##### ### # ### ### ### ##### ### ##### ### ### # ##### ####### ###
#       #             # # # # # #   #     # # #   #   #   # # #       # # #     # #   #   # # #     #
### # # ##### ### # ### # # # # # ##### ##### ### ### ### # # ### # ### ##### ##### ##### # # ### ###
#   # # # # #   # #                 #       # #       #       # # #       # # #       #         #   #
# # ##### # # ##### # # # # # ######### # ### ########### ### # ##### # ### # ### # ##### ### ### ###
# # # #         # # # # # # #   # # # # #   # # # # # #   #     # # # #       #   # # # # # #   #   #
# ### ### ### ### ########### ### # # ### ##### # # # ### ##### # # ############# ### # ### # ### # #
#     #     # #         #     #             # #         #   #         # # # #       #   #       # # #
# ####### ####### ### ##### # ### # # # # ### # ### # ##### ### ### ### # # ### # ### ##### ####### #
#   # # #   # # #   # #     # #   # # # # #       # #     #   # #   #           # #   # #     # #   #
# ### # # ### # # ####### # ##### ######### ######### # ### ####### ### # # # # ##### # ### ### ### #
# # #       #       #     # #       #       # # #   # #   #   # #   #   # # # # # # #   #     #     #
### # ### ### ### ##### # ##### # ##### ### # # ### ### ### ### ### ### ######### # ### ### ### # # #
# #     # #     #   #   #   #   # # #   #       # #       #     #         #           # #   # # # # #
# # ####### ##### # ### ####### ### ### ### ### # ### # ####### ### # # ### ### ### ### ### # ### ###
#     #       #   # #     #       #       # #     # # #     # #   # # # #   #     #     #       #   #
# ######### ####### ### ##### # ### # # ######### # ### # ### ### ######### ### ### # ####### ### # #
# # # # #   # # #   #     #   # #   # #       #       # #       #     #     #     # #     # #   # # #
# # # # ### # # ### ### ##### ######### # # # ##### ##### # # ### # ########### ##### ##### # ##### #
#       # #     # # #     #       # # # # # #   #   # #   # #   # #     # # # #   #     #       #   #
### ### # ##### # ##### # ### # ### # ####### ##### # ####### ##### # ### # # # ########### ####### #
#   #       #     #   # #   # #         #       #       #       # # #           # # # # #     #     #
# # ##### ### ### # ##### ##### # # # ############### ### # # ### ### # # # ##### # # # ### ### # # #
# # # #   # # #     # #     # # # # #     # # # # # #   # # # # #   # # # # # # #         #   # # # #
# ### ### # ### ### # ### ### ####### # ### # # # # # ### ##### # ####### ### # # ### # ### ### #####
#     #       # #     #             # #   #             #     #   # #     #         # #       #     #
########### ### ##### ### # # # ####### ### ### # # # ### # ### ### ### # ### ### ##### #############
# # # # # #   #   #     # # # # # # #     #   # # # # # # #   # #       # #   # # # #     # # # # # #
# # # # # # ######### ####### ### # ### ### ########### ### ### ### # # ##### # ### ### ### # # # # #
#           # # # #   #       #           # # # #     #       # #   # # # #     # #     #           #
# ### # # ### # # ### ### # # ### # # # ### # # ##### ### # ### ### ##### ##### # ######### ####### #
# # # # # #       # #     # # #   # # # #         #   #   # #   #     #   # #     # # #     # # # # #
# # ######### ### # ### # ####### ####### ##### ##### ### ##### ### ##### # ##### # # ### ### # # # #
#   # # # #   #       # #     #     #     # # #   #   #       #       #       #           # #       #
### # # # ### ##### ### ######### ##### ### # # ##### ### # ####### ####### ########### ### # ### ###
#         #     #   # #   # # #     #   #         #     # #     #     # #   #   # # # # # #     #   #
# # # ### ### ##### # ##### # ### ### ##### ### ### ### ### # ##### ### ### # ### # # ### # ##### # #
# # # #         #     # #           # # # #   # #   #   # # #   #         #   #         #     # # # #
# ####### # # ####### # ### # # # ##### # # ##### # ### # ### ######### ##### ### ### ### ##### ### #
#     # # # # # # #         # # # # # #       #   # # #   #     # # # #     # #     #       # # #   #
# # ### ####### # ### # # # ####### # # ### ### # ### # ##### ### # # ### ### ### ### # # ### # ### #
# #   #           # # # # # # #           # #   # #     # #     #       #     #     # # # # #       #
### ####### # ### # ######### # ### # # ####### ##### ### ### ### ### ##### ##### ######### ### # # #
#     # #   # # #           #   # # # # # # #     # # #         #   #   # #   # #   # # #       # # #
### ### ### ### # ### # # ##### # ####### # ### ### # ### # # ### ### ### ##### # ### # ### # # #####
#         # # #     # # #   #       #       #   #     #   # # #     #       #       #       # # # # #
### # # ##### # ######### ####### ### ### ##### ### ##### ####### ### # # ##### ##### # # # ##### # #
# # # #     #     #   #       # #   # #   #     # #   #     # # #   # # #   # #   #   # # # #       #
# ##### # ### ####### ### # ### # ####### ### ### # ##### ### # # ####### ### # ### # ####### ### # #
#     # #       #       # #         # # #     #     # #     #       # #           # #           # # #
# ### ### # # ### ### ##### # # # ### # ### ##### ### ### ### ### ### ### # ########### # ######### #
# #     # # # #   #       # # # # #       # # # # #         #   # #       #   # # # # # # # # # # # #
# ##### ######### ### ############# ### ##### # # ### # # ### ####### # ####### # # # ##### # # # ###
#   #   #         #   # # #           #     #     #   # # #     #     # # # #         # #           #
# # ### ### # # # ### # # # ### ######### ### ### ### ##### ######### ### # ### # ### # ### # ### ###
# # #   #   # # # #           #   # # # #       # #     # # # # # #   #         # #         # # #   #
### ### ### ######### ### ##### ### # # ##### # ##### ### # # # # ####### ####### ### # # ##### # ###
#   #         #     # #     #   #       # # # # #       #         # #     # # # #   # # # # # #     #
# # ### # # ### ### ##### ### # ### ### # # ### ### # ##### # ### # ### ### # # ##### ##### # # ### #
# # # # # # #   #     #     # # #   #         # #   # # # # # #     #   #         # #   # #       # #
# ### ######### ##### ### ######### ### ### ### ### ### # ### ##### ### ### ### ### ##### # ### ### #
#   #             #   #     # # #     # #     # #           #   #       #     #       # #     # #   #
# ### # # # # # ##### ### ### # ### ####### ### ### # # # ########### ##### ### # # ### # ####### # #
#   # # # # # # # # # #   #         # # # #   #   # # # #     # # #   # # #   # # #   #     # #   # #
# ### ########### # # ### ### ####### # # # ### # ####### # ### # ##### # # ####### ### ##### ### ###
#   # # # # # #       #       # # # #         # #   #   # #         #         # #     # # # #       #
# ##### # # # ### ### ######### # # # ### # ##### ##### ### # # # ##### ### ### ### ### # # ##### ###
#     #         #   #   # # # #         # # #         #   # # # #     #   # #         #     # # #   #
# # ### ### # ### ####### # # # ### # ####### # # # ### ######### # ### ####### # # ### ### # # ### #
# #   #   # #       # # #         # # # # #   # # #             # #   #   # #   # # #   #         # #
### ### ### ######### # # ### # ####### # ### ############# # # ### ### ### ### ####### ### ### #####
#     # # # # # # # #       # # #             # # # # # # # # # #     # # #       # # #   # #   # # #
# # ### # ### # # # # ### ########### # # ##### # # # # # ### ##### ### # ##### ### # ##### ### # # #
# # # #   #             #   # # # # # # # # #               # #       #   # #           # # #       #
# ### ### ### ### # # ####### # # # ### ### ### # # # ### ### ### # ##### # ####### # ### ##### ### #
#       # #   # # # #   # #           # #       # # # #     # #   # # # #   # # # # #       #   #   #
# # # ### ### # ##### ### ### # ### ####### # # ######### ####### ### # ### # # # ### # # ######### #
# # #     #     # #   #       # # #   # #   # # #     #   # # #           #         # # #   # # #   #
##### # # ##### # ####### # # ### # ### ### ##### ### ### # # ### # # # ##### ### ####### ### # ### #
#   # # #   #       # #   # # #     #         #     # #       # # # # #   # # # #   # #           # #
# ####### # ##### ### ### ####### ##### # # ### ##### ### ### # ####### ### ### # ### ### # # # ### #
# # # # # #   #   #         # #   # #   # # #     #     # #     #             #     #   # # # #     #
# # # # ### # ### ### # # ### ### # ### ##### ####### ######### ### # # # # ### ####### ####### # ###
#           # #       # #     #                 #           #       # # # #       #             #   #
#####################################################################################################
