#########################################
#     #         #     #           # #   #
# # ### ####### # ### ### # # ### # # ###
# #   # # # # #   # # #   # # #         #
### ##### # # ### # ##### ####### ### ###
#     # #       #   #       # #     #   #
### ### # ### ##### ### # ### ### ### # #
#           #     #     #     #     # # #
### # # # ### # ######### # ##### ##### #
# # # # # # # #   # # # # #   #     #   #
# ######### ### ### # # ### ##### ##### #
#       #         #       # # # #   #   #
### ### ### # # ### ### ##### # # ##### #
#   #   #   # # #     #     #       #   #
# ##### ### ##### ##### # ### ### ##### #
# # # # #     #     # # #       # # #   #
### # # ### ##### ### ### # # ##### ### #
# #     #     # #   #   # # # # # # #   #
# # ####### ### # ##### ####### # # ### #
#   # # #     #     #     #         #   #
# ### # ### ### ######### ### # ### ### #
# #           # # #   # # #   # #   #   #
# ### # # # ### # ### # # ### ##### ### #
# #   # # # #       #     #     #       #
# ### ####### ### ### ####### # ### # # #
#       #     # #   #   # # # #   # # # #
# # # ######### # ### ### # ### #########
# # # # # # #       # #           #     #
# ##### # # ### ##### ### # # # ### ### #
#   #         #   # # #   # # # #   #   #
# ##### ### ### ### # ### ############# #
#   #   # #       #         # # # # # # #
# ##### # ### # ##### # # ### # # # # # #
#   # #     # # #     # # # #           #
# ### ### ####### # # ##### ### ### # # #
#       #   # #   # # #       #   # # # #
# # # ### ### ### ##### ### ### ####### #
# # #       #       #     #   #   # #   #
##### # # ##### # ### ##### ### ### ### #
#     # # #     #       #         #     #
#########################################
