#####################
#       #       #   #
# # # ######### # ###
# # #   # # # #   # #
##### ### # # ### # #
#       #       #   #
### # ### ### ##### #
#   # #     #   # # #
### ### ##### ### # #
#     #   #         #
### ### #############
#     # # # # # # # #
# # ### # # # # # # #
# # #               #
# ### ######### ### #
#   # # # # #   #   #
# ##### # # ####### #
#     #       # # # #
# # ### ### ### # # #
# #       #         #
#####################
